10111111
10100001
10000001
10000001
10000001
11111101
10000001
11011111