11110111
10010101
10010001
10111101
10000001
00111001
10010001
11111111
