11111111
10000101
10100101
00100001
11111101
10000101
10100001
11101111