11111111
10010001
10010101
11010101
10000101
11100100
10000101
11111111
