11101111
10101001
10001101
10111101
10000101
10110101
10010001
11110111
