11111111
10000001
10000101
10000101
10000100
10100001
10100001
10111111