11111111
10000001
11110101
10100100
00101111
10100001
10001001
11111111
